############################
#
#
#
#
#
#
#
#
#



#

#



#
#
#
#
#
###.##.##.########.##.##.###
###.##.##.########.##.##.###
#......##....##....##......#
#.##########.##.##########.#
#.##########.##.##########.#
#..........................#
############################


