############################
#............##............#
#.####.#####.##.#####.####.#
#.####.#####.##.#####.####.#
#.####.#####.##.#####.####.#
#..........................#
#.####.##.########.##.####.#
#.####.##.########.##.####.#
#......##....##....##......#
######.##### ## #####.######
=====#.##### ## #####.#=====
=====#.##          ##.#=====
=====#.## ###--### ##.#=====
######.## #======# ##.######
      .         #======#   .
######.## #======# ##.######
=====#.## ######## ##.#=====
=====#.##          ##.#=====
=====#.## ######## ##.#=====
######.## ######## ##.######
#............##............#
#.####.#####.##.#####.####.#
#.####.#####.##.#####.####.#
#...##................##...#
###.##.##.########.##.##.###
###.##.##.########.##.##.###
#......##....##....##......#
#.##########.##.##########.#
#.##########.##.##########.#
#..........................#
############################


